 _        _______           _______  _          _______ 
( \      (  ____ \|\     /|(  ____ \( \        / ___   )
| (      | (    \/| )   ( || (    \/| (        \/   )  |
| |      | (__    | |   | || (__    | |            /   )
| |      |  __)   ( (   ) )|  __)   | |          _/   / 
| |      | (       \ \_/ / | (      | |         /   _/  
| (____/\| (____/\  \   /  | (____/\| (____/\  (   (__/\
(_______/(_______/   \_/   (_______/(_______/  \_______/