 _        _______           _______  _          __   
( \      (  ____ \|\     /|(  ____ \( \        /  \  
| (      | (    \/| )   ( || (    \/| (        \/) ) 
| |      | (__    | |   | || (__    | |          | | 
| |      |  __)   ( (   ) )|  __)   | |          | | 
| |      | (       \ \_/ / | (      | |          | | 
| (____/\| (____/\  \   /  | (____/\| (____/\  __) (_
(_______/(_______/   \_/   (_______/(_______/  \____/
                                                                  