 _        _______           _______  _          ______  
( \      (  ____ \|\     /|(  ____ \( \        / ___  \ 
| (      | (    \/| )   ( || (    \/| (        \/   \  \
| |      | (__    | |   | || (__    | |           ___) /
| |      |  __)   ( (   ) )|  __)   | |          (___ ( 
| |      | (       \ \_/ / | (      | |              ) \
| (____/\| (____/\  \   /  | (____/\| (____/\  /\___/  /
(_______/(_______/   \_/   (_______/(_______/  \______/ 